locatedInCR(cocos_keeling_islands,oceania).	False
locatedInCR(cuba,americas).	False
locatedInCR(antigua_and_barbuda,americas).	False
locatedInCR(tokelau,oceania).	False
locatedInCR(panama,americas).	True
locatedInCR(trinidad_and_tobago,americas).	False
locatedInCR(turks_and_caicos_islands,americas).	False
locatedInCR(pitcairn_islands,oceania).	False
locatedInCR(lebanon,asia).	True
locatedInCR(sint_maarten,americas).	True
locatedInCR(martinique,americas).	False
locatedInCR(saint_vincent_and_the_grenadines,americas).	False
locatedInCR(niue,oceania).	False
locatedInCR(american_samoa,oceania).	False
locatedInCR(south_korea,asia).	True
locatedInCR(saint_pierre_and_miquelon,americas).	False
locatedInCR(haiti,americas).	True
locatedInCR(mayotte,africa).	False
locatedInCR(cyprus,europe).	False
locatedInCR(aland_islands,europe).	False
locatedInCR(bahrain,asia).	False
locatedInCR(mauritius,africa).	False
locatedInCR(cape_verde,africa).	False
locatedInCR(fiji,oceania).	False
locatedInCR(guadeloupe,americas).	False
locatedInCR(united_states_virgin_islands,americas).	False
locatedInCR(british_indian_ocean_territory,africa).	False
locatedInCR(cayman_islands,americas).	False
locatedInCR(moldova,europe).	True
locatedInCR(wallis_and_futuna,oceania).	False
locatedInCR(jamaica,americas).	False
locatedInCR(christmas_island,oceania).	False
locatedInCR(bermuda,americas).	False
locatedInCR(israel,asia).	True
locatedInCR(united_kingdom,europe).	True
locatedInCR(guernsey,europe).	False
locatedInCR(united_states_minor_outlying_islands,americas).	False
locatedInCR(dominica,americas).	False
locatedInCR(saint_barthelemy,americas).	False
locatedInCR(japan,asia).	False
locatedInCR(saint_kitts_and_nevis,americas).	False
locatedInCR(canada,americas).	True
locatedInCR(anguilla,americas).	False
locatedInCR(northern_mariana_islands,oceania).	False
locatedInCR(british_virgin_islands,americas).	False
locatedInCR(brunei,asia).	True
locatedInCR(marshall_islands,oceania).	False
locatedInCR(grenada,americas).	False
locatedInCR(vanuatu,oceania).	False
locatedInCR(guinea_bissau,africa).	True
locatedInCR(uganda,africa).	True
locatedInCR(new_caledonia,oceania).	False
locatedInCR(sweden,europe).	True
locatedInCR(iceland,europe).	False
locatedInCR(tuvalu,oceania).	False
locatedInCR(palestine,asia).	True
locatedInCR(taiwan,asia).	False
locatedInCR(palau,oceania).	False
locatedInCR(comoros,africa).	False
locatedInCR(nauru,oceania).	False
locatedInCR(saint_martin,americas).	True
locatedInCR(gambia,africa).	True
locatedInCR(malta,europe).	False
locatedInCR(cook_islands,oceania).	False
locatedInCR(faroe_islands,europe).	False
locatedInCR(tonga,oceania).	False
locatedInCR(aruba,americas).	False
locatedInCR(liberia,africa).	True
locatedInCR(falkland_islands,americas).	False
locatedInCR(saint_lucia,americas).	False
locatedInCR(samoa,oceania).	False
locatedInCR(sao_tome_and_principe,africa).	False
locatedInCR(french_polynesia,oceania).	False
locatedInCR(burundi,africa).	True
locatedInCR(svalbard_and_jan_mayen,europe).	False
locatedInCR(philippines,asia).	False
locatedInCR(new_zealand,oceania).	False
locatedInCR(solomon_islands,oceania).	False
locatedInCR(guam,oceania).	False
locatedInCR(reunion,africa).	False
locatedInCR(greenland,americas).	False
locatedInCR(liechtenstein,europe).	True
locatedInCR(south_georgia,americas).	False
locatedInCR(australia,oceania).	False
locatedInCR(kiribati,oceania).	False
locatedInCR(puerto_rico,americas).	False
locatedInCR(barbados,americas).	False
locatedInCR(curacao,americas).	False
locatedInCR(jersey,europe).	False
locatedInCR(norfolk_island,oceania).	False
locatedInCR(ireland,europe).	True
locatedInCR(dominican_republic,americas).	True
locatedInCR(isle_of_man,europe).	False
locatedInCR(seychelles,africa).	False
locatedInCR(madagascar,africa).	False
locatedInCR(bahamas,americas).	False
locatedInCR(rwanda,africa).	True
locatedInCR(maldives,asia).	False
locatedInCR(singapore,asia).	False
locatedInCR(montserrat,americas).	False
