locatedInCR(panama,americas).	True	8	[neighborOf(panama,costa_rica),neighborOf(costa_rica,nicaragua),neighborOf(nicaragua,honduras),neighborOf(honduras,guatemala),neighborOf(guatemala,mexico),neighborOf(mexico,united_states),neighborOf(united_states,canada),locatedInCR(canada,americas)]
locatedInCR(panama,oceania).	False	None	None
locatedInCR(panama,asia).	False	None	None
locatedInCR(panama,europe).	False	None	None
locatedInCR(panama,africa).	False	None	None
locatedInCR(lebanon,asia).	True	2	[neighborOf(lebanon,israel),locatedInCR(israel,asia)]
locatedInCR(lebanon,oceania).	False	None	None
locatedInCR(lebanon,europe).	True	6	[neighborOf(lebanon,syria),neighborOf(syria,turkey),neighborOf(turkey,bulgaria),neighborOf(bulgaria,romania),neighborOf(romania,moldova),locatedInCR(moldova,europe)]
locatedInCR(lebanon,africa).	True	6	[neighborOf(lebanon,israel),neighborOf(israel,egypt),neighborOf(egypt,sudan),neighborOf(sudan,south_sudan),neighborOf(south_sudan,uganda),locatedInCR(uganda,africa)]
locatedInCR(lebanon,americas).	False	None	None
locatedInCR(sint_maarten,americas).	True	2	[neighborOf(sint_maarten,saint_martin),locatedInCR(saint_martin,americas)]
locatedInCR(sint_maarten,oceania).	False	None	None
locatedInCR(sint_maarten,asia).	False	None	None
locatedInCR(sint_maarten,europe).	False	None	None
locatedInCR(sint_maarten,africa).	False	None	None
locatedInCR(south_korea,asia).	True	7	[neighborOf(south_korea,north_korea),neighborOf(north_korea,russia),neighborOf(russia,georgia),neighborOf(georgia,turkey),neighborOf(turkey,syria),neighborOf(syria,israel),locatedInCR(israel,asia)]
locatedInCR(south_korea,oceania).	False	None	None
locatedInCR(south_korea,europe).	True	5	[neighborOf(south_korea,north_korea),neighborOf(north_korea,russia),neighborOf(russia,finland),neighborOf(finland,sweden),locatedInCR(sweden,europe)]
locatedInCR(south_korea,africa).	True	11	[neighborOf(south_korea,north_korea),neighborOf(north_korea,russia),neighborOf(russia,georgia),neighborOf(georgia,turkey),neighborOf(turkey,syria),neighborOf(syria,israel),neighborOf(israel,egypt),neighborOf(egypt,sudan),neighborOf(sudan,south_sudan),neighborOf(south_sudan,uganda),locatedInCR(uganda,africa)]
locatedInCR(south_korea,americas).	False	None	None
locatedInCR(haiti,americas).	True	2	[neighborOf(haiti,dominican_republic),locatedInCR(dominican_republic,americas)]
locatedInCR(haiti,oceania).	False	None	None
locatedInCR(haiti,asia).	False	None	None
locatedInCR(haiti,europe).	False	None	None
locatedInCR(haiti,africa).	False	None	None
locatedInCR(moldova,europe).	True	5	[neighborOf(moldova,ukraine),neighborOf(ukraine,russia),neighborOf(russia,finland),neighborOf(finland,sweden),locatedInCR(sweden,europe)]
locatedInCR(moldova,oceania).	False	None	None
locatedInCR(moldova,asia).	True	5	[neighborOf(moldova,ukraine),neighborOf(ukraine,russia),neighborOf(russia,north_korea),neighborOf(north_korea,south_korea),locatedInCR(south_korea,asia)]
locatedInCR(moldova,africa).	True	10	[neighborOf(moldova,romania),neighborOf(romania,bulgaria),neighborOf(bulgaria,turkey),neighborOf(turkey,syria),neighborOf(syria,israel),neighborOf(israel,egypt),neighborOf(egypt,sudan),neighborOf(sudan,south_sudan),neighborOf(south_sudan,uganda),locatedInCR(uganda,africa)]
locatedInCR(moldova,americas).	False	None	None
locatedInCR(israel,asia).	True	2	[neighborOf(israel,lebanon),locatedInCR(lebanon,asia)]
locatedInCR(israel,oceania).	False	None	None
locatedInCR(israel,europe).	True	6	[neighborOf(israel,syria),neighborOf(syria,turkey),neighborOf(turkey,bulgaria),neighborOf(bulgaria,romania),neighborOf(romania,moldova),locatedInCR(moldova,europe)]
locatedInCR(israel,africa).	True	5	[neighborOf(israel,egypt),neighborOf(egypt,sudan),neighborOf(sudan,south_sudan),neighborOf(south_sudan,uganda),locatedInCR(uganda,africa)]
locatedInCR(israel,americas).	False	None	None
locatedInCR(united_kingdom,europe).	True	2	[neighborOf(united_kingdom,ireland),locatedInCR(ireland,europe)]
locatedInCR(united_kingdom,oceania).	False	None	None
locatedInCR(united_kingdom,asia).	False	None	None
locatedInCR(united_kingdom,africa).	False	None	None
locatedInCR(united_kingdom,americas).	False	None	None
locatedInCR(canada,americas).	True	8	[neighborOf(canada,united_states),neighborOf(united_states,mexico),neighborOf(mexico,guatemala),neighborOf(guatemala,honduras),neighborOf(honduras,nicaragua),neighborOf(nicaragua,costa_rica),neighborOf(costa_rica,panama),locatedInCR(panama,americas)]
locatedInCR(canada,oceania).	False	None	None
locatedInCR(canada,asia).	False	None	None
locatedInCR(canada,europe).	False	None	None
locatedInCR(canada,africa).	False	None	None
locatedInCR(brunei,asia).	True	7	[neighborOf(brunei,malaysia),neighborOf(malaysia,thailand),neighborOf(thailand,myanmar),neighborOf(myanmar,china),neighborOf(china,north_korea),neighborOf(north_korea,south_korea),locatedInCR(south_korea,asia)]
locatedInCR(brunei,oceania).	False	None	None
locatedInCR(brunei,europe).	True	8	[neighborOf(brunei,malaysia),neighborOf(malaysia,thailand),neighborOf(thailand,myanmar),neighborOf(myanmar,china),neighborOf(china,russia),neighborOf(russia,finland),neighborOf(finland,sweden),locatedInCR(sweden,europe)]
locatedInCR(brunei,africa).	True	None	None
locatedInCR(brunei,americas).	False	None	None
locatedInCR(guinea_bissau,africa).	True	3	[neighborOf(guinea_bissau,guinea),neighborOf(guinea,liberia),locatedInCR(liberia,africa)]
locatedInCR(guinea_bissau,oceania).	False	None	None
locatedInCR(guinea_bissau,asia).	True	7	[neighborOf(guinea_bissau,guinea),neighborOf(guinea,mali),neighborOf(mali,niger),neighborOf(niger,libya),neighborOf(libya,egypt),neighborOf(egypt,israel),locatedInCR(israel,asia)]
locatedInCR(guinea_bissau,europe).	True	9	[neighborOf(guinea_bissau,guinea),neighborOf(guinea,mali),neighborOf(mali,algeria),neighborOf(algeria,morocco),neighborOf(morocco,spain),neighborOf(spain,france),neighborOf(france,switzerland),neighborOf(switzerland,liechtenstein),locatedInCR(liechtenstein,europe)]
locatedInCR(guinea_bissau,americas).	False	None	None
locatedInCR(uganda,africa).	True	2	[neighborOf(uganda,rwanda),locatedInCR(rwanda,africa)]
locatedInCR(uganda,oceania).	False	None	None
locatedInCR(uganda,asia).	True	5	[neighborOf(uganda,south_sudan),neighborOf(south_sudan,sudan),neighborOf(sudan,egypt),neighborOf(egypt,israel),locatedInCR(israel,asia)]
locatedInCR(uganda,europe).	True	10	[neighborOf(uganda,south_sudan),neighborOf(south_sudan,sudan),neighborOf(sudan,egypt),neighborOf(egypt,israel),neighborOf(israel,syria),neighborOf(syria,turkey),neighborOf(turkey,bulgaria),neighborOf(bulgaria,romania),neighborOf(romania,moldova),locatedInCR(moldova,europe)]
locatedInCR(uganda,americas).	False	None	None
locatedInCR(sweden,europe).	True	5	[neighborOf(sweden,finland),neighborOf(finland,russia),neighborOf(russia,ukraine),neighborOf(ukraine,moldova),locatedInCR(moldova,europe)]
locatedInCR(sweden,oceania).	False	None	None
locatedInCR(sweden,asia).	True	5	[neighborOf(sweden,finland),neighborOf(finland,russia),neighborOf(russia,north_korea),neighborOf(north_korea,south_korea),locatedInCR(south_korea,asia)]
locatedInCR(sweden,africa).	True	11	[neighborOf(sweden,finland),neighborOf(finland,russia),neighborOf(russia,georgia),neighborOf(georgia,turkey),neighborOf(turkey,syria),neighborOf(syria,israel),neighborOf(israel,egypt),neighborOf(egypt,sudan),neighborOf(sudan,south_sudan),neighborOf(south_sudan,uganda),locatedInCR(uganda,africa)]
locatedInCR(sweden,americas).	False	None	None
locatedInCR(palestine,asia).	True	2	[neighborOf(palestine,israel),locatedInCR(israel,asia)]
locatedInCR(palestine,oceania).	False	None	None
locatedInCR(palestine,europe).	True	7	[neighborOf(palestine,jordan),neighborOf(jordan,syria),neighborOf(syria,turkey),neighborOf(turkey,bulgaria),neighborOf(bulgaria,romania),neighborOf(romania,moldova),locatedInCR(moldova,europe)]
locatedInCR(palestine,africa).	True	5	[neighborOf(palestine,egypt),neighborOf(egypt,sudan),neighborOf(sudan,south_sudan),neighborOf(south_sudan,uganda),locatedInCR(uganda,africa)]
locatedInCR(palestine,americas).	False	None	None
locatedInCR(saint_martin,americas).	True	2	[neighborOf(saint_martin,sint_maarten),locatedInCR(sint_maarten,americas)]
locatedInCR(saint_martin,oceania).	False	None	None
locatedInCR(saint_martin,asia).	False	None	None
locatedInCR(saint_martin,europe).	False	None	None
locatedInCR(saint_martin,africa).	False	None	None
locatedInCR(gambia,africa).	True	3	[neighborOf(gambia,senegal),neighborOf(senegal,guinea_bissau),locatedInCR(guinea_bissau,africa)]
locatedInCR(gambia,oceania).	False	None	None
locatedInCR(gambia,asia).	True	7	[neighborOf(gambia,senegal),neighborOf(senegal,mauritania),neighborOf(mauritania,algeria),neighborOf(algeria,libya),neighborOf(libya,egypt),neighborOf(egypt,israel),locatedInCR(israel,asia)]
locatedInCR(gambia,europe).	True	9	[neighborOf(gambia,senegal),neighborOf(senegal,mauritania),neighborOf(mauritania,western_sahara),neighborOf(western_sahara,morocco),neighborOf(morocco,spain),neighborOf(spain,france),neighborOf(france,switzerland),neighborOf(switzerland,liechtenstein),locatedInCR(liechtenstein,europe)]
locatedInCR(gambia,americas).	False	None	None
locatedInCR(liberia,africa).	True	3	[neighborOf(liberia,guinea),neighborOf(guinea,guinea_bissau),locatedInCR(guinea_bissau,africa)]
locatedInCR(liberia,oceania).	False	None	None
locatedInCR(liberia,asia).	True	7	[neighborOf(liberia,ivory_coast),neighborOf(ivory_coast,mali),neighborOf(mali,niger),neighborOf(niger,libya),neighborOf(libya,egypt),neighborOf(egypt,israel),locatedInCR(israel,asia)]
locatedInCR(liberia,europe).	True	9	[neighborOf(liberia,ivory_coast),neighborOf(ivory_coast,mali),neighborOf(mali,algeria),neighborOf(algeria,morocco),neighborOf(morocco,spain),neighborOf(spain,france),neighborOf(france,switzerland),neighborOf(switzerland,liechtenstein),locatedInCR(liechtenstein,europe)]
locatedInCR(liberia,americas).	False	None	None
locatedInCR(burundi,africa).	True	2	[neighborOf(burundi,rwanda),locatedInCR(rwanda,africa)]
locatedInCR(burundi,oceania).	False	None	None
locatedInCR(burundi,asia).	True	6	[neighborOf(burundi,dr_congo),neighborOf(dr_congo,south_sudan),neighborOf(south_sudan,sudan),neighborOf(sudan,egypt),neighborOf(egypt,israel),locatedInCR(israel,asia)]
locatedInCR(burundi,europe).	True	11	[neighborOf(burundi,dr_congo),neighborOf(dr_congo,south_sudan),neighborOf(south_sudan,sudan),neighborOf(sudan,egypt),neighborOf(egypt,israel),neighborOf(israel,syria),neighborOf(syria,turkey),neighborOf(turkey,bulgaria),neighborOf(bulgaria,romania),neighborOf(romania,moldova),locatedInCR(moldova,europe)]
locatedInCR(burundi,americas).	False	None	None
locatedInCR(liechtenstein,europe).	True	5	[neighborOf(liechtenstein,austria),neighborOf(austria,hungary),neighborOf(hungary,ukraine),neighborOf(ukraine,moldova),locatedInCR(moldova,europe)]
locatedInCR(liechtenstein,oceania).	False	None	None
locatedInCR(liechtenstein,asia).	True	7	[neighborOf(liechtenstein,austria),neighborOf(austria,germany),neighborOf(germany,poland),neighborOf(poland,russia),neighborOf(russia,north_korea),neighborOf(north_korea,south_korea),locatedInCR(south_korea,asia)]
locatedInCR(liechtenstein,africa).	True	9	[neighborOf(liechtenstein,switzerland),neighborOf(switzerland,france),neighborOf(france,spain),neighborOf(spain,morocco),neighborOf(morocco,algeria),neighborOf(algeria,mauritania),neighborOf(mauritania,senegal),neighborOf(senegal,guinea_bissau),locatedInCR(guinea_bissau,africa)]
locatedInCR(liechtenstein,americas).	False	None	None
locatedInCR(ireland,europe).	True	2	[neighborOf(ireland,united_kingdom),locatedInCR(united_kingdom,europe)]
locatedInCR(ireland,oceania).	False	None	None
locatedInCR(ireland,asia).	False	None	None
locatedInCR(ireland,africa).	False	None	None
locatedInCR(ireland,americas).	False	None	None
locatedInCR(dominican_republic,americas).	True	2	[neighborOf(dominican_republic,haiti),locatedInCR(haiti,americas)]
locatedInCR(dominican_republic,oceania).	False	None	None
locatedInCR(dominican_republic,asia).	False	None	None
locatedInCR(dominican_republic,europe).	False	None	None
locatedInCR(dominican_republic,africa).	False	None	None
locatedInCR(rwanda,africa).	True	2	[neighborOf(rwanda,burundi),locatedInCR(burundi,africa)]
locatedInCR(rwanda,oceania).	False	None	None
locatedInCR(rwanda,asia).	True	6	[neighborOf(rwanda,dr_congo),neighborOf(dr_congo,south_sudan),neighborOf(south_sudan,sudan),neighborOf(sudan,egypt),neighborOf(egypt,israel),locatedInCR(israel,asia)]
locatedInCR(rwanda,europe).	True	11	[neighborOf(rwanda,dr_congo),neighborOf(dr_congo,south_sudan),neighborOf(south_sudan,sudan),neighborOf(sudan,egypt),neighborOf(egypt,israel),neighborOf(israel,syria),neighborOf(syria,turkey),neighborOf(turkey,bulgaria),neighborOf(bulgaria,romania),neighborOf(romania,moldova),locatedInCR(moldova,europe)]
locatedInCR(rwanda,americas).	False	None	None
