locatedInCR(botswana,africa).	True	2	[neighborOf(botswana,south_africa),locatedInCR(south_africa,africa)]
locatedInCR(botswana,oceania).	True	None	None
locatedInCR(botswana,asia).	True	7	[neighborOf(botswana,zambia),neighborOf(zambia,dr_congo),neighborOf(dr_congo,south_sudan),neighborOf(south_sudan,sudan),neighborOf(sudan,egypt),neighborOf(egypt,israel),locatedInCR(israel,asia)]
locatedInCR(botswana,europe).	True	9	[neighborOf(botswana,zambia),neighborOf(zambia,dr_congo),neighborOf(dr_congo,south_sudan),neighborOf(south_sudan,sudan),neighborOf(sudan,libya),neighborOf(libya,algeria),neighborOf(algeria,morocco),neighborOf(morocco,spain),locatedInCR(spain,europe)]
locatedInCR(botswana,americas).	False	None	None
locatedInCR(guinea,africa).	True	2	[neighborOf(guinea,ivory_coast),locatedInCR(ivory_coast,africa)]
locatedInCR(guinea,oceania).	True	None	None
locatedInCR(guinea,asia).	True	6	[neighborOf(guinea,mali),neighborOf(mali,niger),neighborOf(niger,libya),neighborOf(libya,egypt),neighborOf(egypt,israel),locatedInCR(israel,asia)]
locatedInCR(guinea,europe).	True	5	[neighborOf(guinea,mali),neighborOf(mali,algeria),neighborOf(algeria,morocco),neighborOf(morocco,spain),locatedInCR(spain,europe)]
locatedInCR(guinea,americas).	False	None	None
locatedInCR(belize,americas).	True	3	[neighborOf(belize,guatemala),neighborOf(guatemala,honduras),locatedInCR(honduras,americas)]
locatedInCR(belize,oceania).	False	None	None
locatedInCR(belize,asia).	False	None	None
locatedInCR(belize,europe).	False	None	None
locatedInCR(belize,africa).	False	None	None
locatedInCR(south_korea,asia).	True	3	[neighborOf(south_korea,north_korea),neighborOf(north_korea,china),locatedInCR(china,asia)]
locatedInCR(south_korea,oceania).	True	8	[neighborOf(south_korea,north_korea),neighborOf(north_korea,china),neighborOf(china,myanmar),neighborOf(myanmar,thailand),neighborOf(thailand,malaysia),neighborOf(malaysia,indonesia),neighborOf(indonesia,papua_new_guinea),locatedInCR(papua_new_guinea,oceania)]
locatedInCR(south_korea,europe).	True	3	[neighborOf(south_korea,north_korea),neighborOf(north_korea,russia),locatedInCR(russia,europe)]
locatedInCR(south_korea,africa).	True	9	[neighborOf(south_korea,north_korea),neighborOf(north_korea,russia),neighborOf(russia,georgia),neighborOf(georgia,turkey),neighborOf(turkey,syria),neighborOf(syria,israel),neighborOf(israel,egypt),neighborOf(egypt,libya),locatedInCR(libya,africa)]
locatedInCR(south_korea,americas).	False	None	None
locatedInCR(albania,europe).	True	3	[neighborOf(albania,montenegro),neighborOf(montenegro,bosnia_and_herzegovina),locatedInCR(bosnia_and_herzegovina,europe)]
locatedInCR(albania,oceania).	True	11	[neighborOf(albania,greece),neighborOf(greece,turkey),neighborOf(turkey,azerbaijan),neighborOf(azerbaijan,russia),neighborOf(russia,china),neighborOf(china,myanmar),neighborOf(myanmar,thailand),neighborOf(thailand,malaysia),neighborOf(malaysia,indonesia),neighborOf(indonesia,papua_new_guinea),locatedInCR(papua_new_guinea,oceania)]
locatedInCR(albania,asia).	True	4	[neighborOf(albania,greece),neighborOf(greece,turkey),neighborOf(turkey,azerbaijan),locatedInCR(azerbaijan,asia)]
locatedInCR(albania,africa).	True	7	[neighborOf(albania,greece),neighborOf(greece,turkey),neighborOf(turkey,syria),neighborOf(syria,israel),neighborOf(israel,egypt),neighborOf(egypt,libya),locatedInCR(libya,africa)]
locatedInCR(albania,americas).	False	None	None
locatedInCR(canada,americas).	True	4	[neighborOf(canada,united_states),neighborOf(united_states,mexico),neighborOf(mexico,belize),locatedInCR(belize,americas)]
locatedInCR(canada,oceania).	False	None	None
locatedInCR(canada,asia).	False	None	None
locatedInCR(canada,europe).	False	None	None
locatedInCR(canada,africa).	False	None	None
locatedInCR(ireland,europe).	True	2	[neighborOf(ireland,united_kingdom),locatedInCR(united_kingdom,europe)]
locatedInCR(ireland,oceania).	False	None	None
locatedInCR(ireland,asia).	False	None	None
locatedInCR(ireland,africa).	False	None	None
locatedInCR(ireland,americas).	False	None	None
locatedInCR(paraguay,americas).	True	2	[neighborOf(paraguay,brazil),locatedInCR(brazil,americas)]
locatedInCR(paraguay,oceania).	False	None	None
locatedInCR(paraguay,asia).	False	None	None
locatedInCR(paraguay,europe).	False	None	None
locatedInCR(paraguay,africa).	False	None	None
locatedInCR(denmark,europe).	True	3	[neighborOf(denmark,germany),neighborOf(germany,switzerland),locatedInCR(switzerland,europe)]
locatedInCR(denmark,oceania).	True	10	[neighborOf(denmark,germany),neighborOf(germany,poland),neighborOf(poland,russia),neighborOf(russia,china),neighborOf(china,myanmar),neighborOf(myanmar,thailand),neighborOf(thailand,malaysia),neighborOf(malaysia,indonesia),neighborOf(indonesia,papua_new_guinea),locatedInCR(papua_new_guinea,oceania)]
locatedInCR(denmark,asia).	True	5	[neighborOf(denmark,germany),neighborOf(germany,poland),neighborOf(poland,russia),neighborOf(russia,georgia),locatedInCR(georgia,asia)]
locatedInCR(denmark,africa).	True	6	[neighborOf(denmark,germany),neighborOf(germany,france),neighborOf(france,spain),neighborOf(spain,morocco),neighborOf(morocco,western_sahara),locatedInCR(western_sahara,africa)]
locatedInCR(denmark,americas).	False	None	None
locatedInCR(georgia,asia).	True	2	[neighborOf(georgia,azerbaijan),locatedInCR(azerbaijan,asia)]
locatedInCR(georgia,oceania).	True	8	[neighborOf(georgia,russia),neighborOf(russia,china),neighborOf(china,myanmar),neighborOf(myanmar,thailand),neighborOf(thailand,malaysia),neighborOf(malaysia,indonesia),neighborOf(indonesia,papua_new_guinea),locatedInCR(papua_new_guinea,oceania)]
locatedInCR(georgia,europe).	True	2	[neighborOf(georgia,russia),locatedInCR(russia,europe)]
locatedInCR(georgia,africa).	True	6	[neighborOf(georgia,turkey),neighborOf(turkey,syria),neighborOf(syria,israel),neighborOf(israel,egypt),neighborOf(egypt,libya),locatedInCR(libya,africa)]
locatedInCR(georgia,americas).	False	None	None
locatedInCR(algeria,africa).	True	2	[neighborOf(algeria,western_sahara),locatedInCR(western_sahara,africa)]
locatedInCR(algeria,oceania).	True	None	None
locatedInCR(algeria,asia).	True	4	[neighborOf(algeria,libya),neighborOf(libya,egypt),neighborOf(egypt,israel),locatedInCR(israel,asia)]
locatedInCR(algeria,europe).	True	3	[neighborOf(algeria,morocco),neighborOf(morocco,spain),locatedInCR(spain,europe)]
locatedInCR(algeria,americas).	False	None	None
locatedInCR(united_kingdom,europe).	True	2	[neighborOf(united_kingdom,ireland),locatedInCR(ireland,europe)]
locatedInCR(united_kingdom,oceania).	False	None	None
locatedInCR(united_kingdom,asia).	False	None	None
locatedInCR(united_kingdom,africa).	False	None	None
locatedInCR(united_kingdom,americas).	False	None	None
locatedInCR(switzerland,europe).	True	2	[neighborOf(switzerland,austria),locatedInCR(austria,europe)]
locatedInCR(switzerland,oceania).	True	10	[neighborOf(switzerland,germany),neighborOf(germany,poland),neighborOf(poland,russia),neighborOf(russia,china),neighborOf(china,myanmar),neighborOf(myanmar,thailand),neighborOf(thailand,malaysia),neighborOf(malaysia,indonesia),neighborOf(indonesia,papua_new_guinea),locatedInCR(papua_new_guinea,oceania)]
locatedInCR(switzerland,asia).	True	5	[neighborOf(switzerland,germany),neighborOf(germany,poland),neighborOf(poland,russia),neighborOf(russia,georgia),locatedInCR(georgia,asia)]
locatedInCR(switzerland,africa).	True	5	[neighborOf(switzerland,france),neighborOf(france,spain),neighborOf(spain,morocco),neighborOf(morocco,western_sahara),locatedInCR(western_sahara,africa)]
locatedInCR(switzerland,americas).	False	None	None
locatedInCR(san_marino,europe).	True	2	[neighborOf(san_marino,italy),locatedInCR(italy,europe)]
locatedInCR(san_marino,oceania).	True	None	None
locatedInCR(san_marino,asia).	True	7	[neighborOf(san_marino,italy),neighborOf(italy,austria),neighborOf(austria,germany),neighborOf(germany,poland),neighborOf(poland,russia),neighborOf(russia,georgia),locatedInCR(georgia,asia)]
locatedInCR(san_marino,africa).	True	6	[neighborOf(san_marino,italy),neighborOf(italy,france),neighborOf(france,spain),neighborOf(spain,morocco),neighborOf(morocco,western_sahara),locatedInCR(western_sahara,africa)]
locatedInCR(san_marino,americas).	False	None	None
locatedInCR(el_salvador,americas).	True	2	[neighborOf(el_salvador,honduras),locatedInCR(honduras,americas)]
locatedInCR(el_salvador,oceania).	False	None	None
locatedInCR(el_salvador,asia).	False	None	None
locatedInCR(el_salvador,europe).	False	None	None
locatedInCR(el_salvador,africa).	False	None	None
locatedInCR(south_africa,africa).	True	2	[neighborOf(south_africa,botswana),locatedInCR(botswana,africa)]
locatedInCR(south_africa,oceania).	True	None	None
locatedInCR(south_africa,asia).	True	8	[neighborOf(south_africa,namibia),neighborOf(namibia,zambia),neighborOf(zambia,dr_congo),neighborOf(dr_congo,south_sudan),neighborOf(south_sudan,sudan),neighborOf(sudan,egypt),neighborOf(egypt,israel),locatedInCR(israel,asia)]
locatedInCR(south_africa,europe).	True	10	[neighborOf(south_africa,namibia),neighborOf(namibia,zambia),neighborOf(zambia,dr_congo),neighborOf(dr_congo,south_sudan),neighborOf(south_sudan,sudan),neighborOf(sudan,libya),neighborOf(libya,algeria),neighborOf(algeria,morocco),neighborOf(morocco,spain),locatedInCR(spain,europe)]
locatedInCR(south_africa,americas).	False	None	None
locatedInCR(brazil,americas).	True	2	[neighborOf(brazil,bolivia),locatedInCR(bolivia,americas)]
locatedInCR(brazil,oceania).	False	None	None
locatedInCR(brazil,asia).	False	None	None
locatedInCR(brazil,europe).	False	None	None
locatedInCR(brazil,africa).	False	None	None
locatedInCR(india,asia).	True	2	[neighborOf(india,china),locatedInCR(china,asia)]
locatedInCR(india,oceania).	True	6	[neighborOf(india,myanmar),neighborOf(myanmar,thailand),neighborOf(thailand,malaysia),neighborOf(malaysia,indonesia),neighborOf(indonesia,papua_new_guinea),locatedInCR(papua_new_guinea,oceania)]
locatedInCR(india,europe).	True	3	[neighborOf(india,china),neighborOf(china,russia),locatedInCR(russia,europe)]
locatedInCR(india,africa).	True	8	[neighborOf(india,afghanistan),neighborOf(afghanistan,iran),neighborOf(iran,iraq),neighborOf(iraq,jordan),neighborOf(jordan,israel),neighborOf(israel,egypt),neighborOf(egypt,libya),locatedInCR(libya,africa)]
locatedInCR(india,americas).	False	None	None
locatedInCR(ukraine,europe).	True	2	[neighborOf(ukraine,moldova),locatedInCR(moldova,europe)]
locatedInCR(ukraine,oceania).	True	8	[neighborOf(ukraine,russia),neighborOf(russia,china),neighborOf(china,myanmar),neighborOf(myanmar,thailand),neighborOf(thailand,malaysia),neighborOf(malaysia,indonesia),neighborOf(indonesia,papua_new_guinea),locatedInCR(papua_new_guinea,oceania)]
locatedInCR(ukraine,asia).	True	3	[neighborOf(ukraine,russia),neighborOf(russia,georgia),locatedInCR(georgia,asia)]
locatedInCR(ukraine,africa).	True	7	[neighborOf(ukraine,poland),neighborOf(poland,germany),neighborOf(germany,france),neighborOf(france,spain),neighborOf(spain,morocco),neighborOf(morocco,western_sahara),locatedInCR(western_sahara,africa)]
locatedInCR(ukraine,americas).	False	None	None
locatedInCR(portugal,europe).	True	2	[neighborOf(portugal,spain),locatedInCR(spain,europe)]
locatedInCR(portugal,oceania).	True	None	None
locatedInCR(portugal,asia).	True	7	[neighborOf(portugal,spain),neighborOf(spain,morocco),neighborOf(morocco,algeria),neighborOf(algeria,libya),neighborOf(libya,egypt),neighborOf(egypt,israel),locatedInCR(israel,asia)]
locatedInCR(portugal,africa).	True	4	[neighborOf(portugal,spain),neighborOf(spain,morocco),neighborOf(morocco,western_sahara),locatedInCR(western_sahara,africa)]
locatedInCR(portugal,americas).	False	None	None
locatedInCR(south_sudan,africa).	True	2	[neighborOf(south_sudan,sudan),locatedInCR(sudan,africa)]
locatedInCR(south_sudan,oceania).	True	None	None
locatedInCR(south_sudan,asia).	True	4	[neighborOf(south_sudan,sudan),neighborOf(sudan,egypt),neighborOf(egypt,israel),locatedInCR(israel,asia)]
locatedInCR(south_sudan,europe).	True	6	[neighborOf(south_sudan,sudan),neighborOf(sudan,libya),neighborOf(libya,algeria),neighborOf(algeria,morocco),neighborOf(morocco,spain),locatedInCR(spain,europe)]
locatedInCR(south_sudan,americas).	False	None	None
locatedInCR(sweden,europe).	True	2	[neighborOf(sweden,finland),locatedInCR(finland,europe)]
locatedInCR(sweden,oceania).	True	9	[neighborOf(sweden,finland),neighborOf(finland,russia),neighborOf(russia,china),neighborOf(china,myanmar),neighborOf(myanmar,thailand),neighborOf(thailand,malaysia),neighborOf(malaysia,indonesia),neighborOf(indonesia,papua_new_guinea),locatedInCR(papua_new_guinea,oceania)]
locatedInCR(sweden,asia).	True	4	[neighborOf(sweden,finland),neighborOf(finland,russia),neighborOf(russia,georgia),locatedInCR(georgia,asia)]
locatedInCR(sweden,africa).	True	9	[neighborOf(sweden,finland),neighborOf(finland,russia),neighborOf(russia,georgia),neighborOf(georgia,turkey),neighborOf(turkey,syria),neighborOf(syria,israel),neighborOf(israel,egypt),neighborOf(egypt,libya),locatedInCR(libya,africa)]
locatedInCR(sweden,americas).	False	None	None
locatedInCR(armenia,asia).	True	2	[neighborOf(armenia,georgia),locatedInCR(georgia,asia)]
locatedInCR(armenia,oceania).	True	9	[neighborOf(armenia,georgia),neighborOf(georgia,russia),neighborOf(russia,china),neighborOf(china,myanmar),neighborOf(myanmar,thailand),neighborOf(thailand,malaysia),neighborOf(malaysia,indonesia),neighborOf(indonesia,papua_new_guinea),locatedInCR(papua_new_guinea,oceania)]
locatedInCR(armenia,europe).	True	3	[neighborOf(armenia,georgia),neighborOf(georgia,russia),locatedInCR(russia,europe)]
locatedInCR(armenia,africa).	True	6	[neighborOf(armenia,turkey),neighborOf(turkey,syria),neighborOf(syria,israel),neighborOf(israel,egypt),neighborOf(egypt,libya),locatedInCR(libya,africa)]
locatedInCR(armenia,americas).	False	None	None
locatedInCR(argentina,americas).	True	2	[neighborOf(argentina,bolivia),locatedInCR(bolivia,americas)]
locatedInCR(argentina,oceania).	False	None	None
locatedInCR(argentina,asia).	False	None	None
locatedInCR(argentina,europe).	False	None	None
locatedInCR(argentina,africa).	False	None	None
locatedInCR(benin,africa).	True	2	[neighborOf(benin,nigeria),locatedInCR(nigeria,africa)]
locatedInCR(benin,oceania).	True	None	None
locatedInCR(benin,asia).	True	5	[neighborOf(benin,niger),neighborOf(niger,libya),neighborOf(libya,egypt),neighborOf(egypt,israel),locatedInCR(israel,asia)]
locatedInCR(benin,europe).	True	5	[neighborOf(benin,niger),neighborOf(niger,algeria),neighborOf(algeria,morocco),neighborOf(morocco,spain),locatedInCR(spain,europe)]
locatedInCR(benin,americas).	False	None	None
locatedInCR(honduras,americas).	True	2	[neighborOf(honduras,el_salvador),locatedInCR(el_salvador,americas)]
locatedInCR(honduras,oceania).	False	None	None
locatedInCR(honduras,asia).	False	None	None
locatedInCR(honduras,europe).	False	None	None
locatedInCR(honduras,africa).	False	None	None
locatedInCR(china,asia).	True	2	[neighborOf(china,macau),locatedInCR(macau,asia)]
locatedInCR(china,oceania).	True	6	[neighborOf(china,myanmar),neighborOf(myanmar,thailand),neighborOf(thailand,malaysia),neighborOf(malaysia,indonesia),neighborOf(indonesia,papua_new_guinea),locatedInCR(papua_new_guinea,oceania)]
locatedInCR(china,europe).	True	2	[neighborOf(china,russia),locatedInCR(russia,europe)]
locatedInCR(china,africa).	True	8	[neighborOf(china,afghanistan),neighborOf(afghanistan,iran),neighborOf(iran,iraq),neighborOf(iraq,jordan),neighborOf(jordan,israel),neighborOf(israel,egypt),neighborOf(egypt,libya),locatedInCR(libya,africa)]
locatedInCR(china,americas).	False	None	None
locatedInCR(thailand,asia).	True	2	[neighborOf(thailand,malaysia),locatedInCR(malaysia,asia)]
locatedInCR(thailand,oceania).	True	4	[neighborOf(thailand,malaysia),neighborOf(malaysia,indonesia),neighborOf(indonesia,papua_new_guinea),locatedInCR(papua_new_guinea,oceania)]
locatedInCR(thailand,europe).	True	4	[neighborOf(thailand,myanmar),neighborOf(myanmar,china),neighborOf(china,russia),locatedInCR(russia,europe)]
locatedInCR(thailand,africa).	True	10	[neighborOf(thailand,myanmar),neighborOf(myanmar,china),neighborOf(china,afghanistan),neighborOf(afghanistan,iran),neighborOf(iran,iraq),neighborOf(iraq,jordan),neighborOf(jordan,israel),neighborOf(israel,egypt),neighborOf(egypt,libya),locatedInCR(libya,africa)]
locatedInCR(thailand,americas).	False	None	None
locatedInCR(zambia,africa).	True	2	[neighborOf(zambia,botswana),locatedInCR(botswana,africa)]
locatedInCR(zambia,oceania).	True	None	None
locatedInCR(zambia,asia).	True	6	[neighborOf(zambia,dr_congo),neighborOf(dr_congo,south_sudan),neighborOf(south_sudan,sudan),neighborOf(sudan,egypt),neighborOf(egypt,israel),locatedInCR(israel,asia)]
locatedInCR(zambia,europe).	True	8	[neighborOf(zambia,dr_congo),neighborOf(dr_congo,south_sudan),neighborOf(south_sudan,sudan),neighborOf(sudan,libya),neighborOf(libya,algeria),neighborOf(algeria,morocco),neighborOf(morocco,spain),locatedInCR(spain,europe)]
locatedInCR(zambia,americas).	False	None	None
locatedInCR(malaysia,asia).	True	2	[neighborOf(malaysia,thailand),locatedInCR(thailand,asia)]
locatedInCR(malaysia,oceania).	True	3	[neighborOf(malaysia,indonesia),neighborOf(indonesia,papua_new_guinea),locatedInCR(papua_new_guinea,oceania)]
locatedInCR(malaysia,europe).	True	5	[neighborOf(malaysia,thailand),neighborOf(thailand,myanmar),neighborOf(myanmar,china),neighborOf(china,russia),locatedInCR(russia,europe)]
locatedInCR(malaysia,africa).	True	11	[neighborOf(malaysia,thailand),neighborOf(thailand,myanmar),neighborOf(myanmar,china),neighborOf(china,afghanistan),neighborOf(afghanistan,iran),neighborOf(iran,iraq),neighborOf(iraq,jordan),neighborOf(jordan,israel),neighborOf(israel,egypt),neighborOf(egypt,libya),locatedInCR(libya,africa)]
locatedInCR(malaysia,americas).	False	None	None
locatedInCR(qatar,asia).	True	3	[neighborOf(qatar,saudi_arabia),neighborOf(saudi_arabia,yemen),locatedInCR(yemen,asia)]
locatedInCR(qatar,oceania).	True	11	[neighborOf(qatar,saudi_arabia),neighborOf(saudi_arabia,iraq),neighborOf(iraq,iran),neighborOf(iran,afghanistan),neighborOf(afghanistan,china),neighborOf(china,myanmar),neighborOf(myanmar,thailand),neighborOf(thailand,malaysia),neighborOf(malaysia,indonesia),neighborOf(indonesia,papua_new_guinea),locatedInCR(papua_new_guinea,oceania)]
locatedInCR(qatar,europe).	True	6	[neighborOf(qatar,saudi_arabia),neighborOf(saudi_arabia,iraq),neighborOf(iraq,turkey),neighborOf(turkey,azerbaijan),neighborOf(azerbaijan,russia),locatedInCR(russia,europe)]
locatedInCR(qatar,africa).	True	6	[neighborOf(qatar,saudi_arabia),neighborOf(saudi_arabia,jordan),neighborOf(jordan,israel),neighborOf(israel,egypt),neighborOf(egypt,libya),locatedInCR(libya,africa)]
locatedInCR(qatar,americas).	False	None	None
locatedInCR(kazakhstan,asia).	True	2	[neighborOf(kazakhstan,china),locatedInCR(china,asia)]
locatedInCR(kazakhstan,oceania).	True	7	[neighborOf(kazakhstan,china),neighborOf(china,myanmar),neighborOf(myanmar,thailand),neighborOf(thailand,malaysia),neighborOf(malaysia,indonesia),neighborOf(indonesia,papua_new_guinea),locatedInCR(papua_new_guinea,oceania)]
locatedInCR(kazakhstan,europe).	True	2	[neighborOf(kazakhstan,russia),locatedInCR(russia,europe)]
locatedInCR(kazakhstan,africa).	True	8	[neighborOf(kazakhstan,turkmenistan),neighborOf(turkmenistan,iran),neighborOf(iran,iraq),neighborOf(iraq,jordan),neighborOf(jordan,israel),neighborOf(israel,egypt),neighborOf(egypt,libya),locatedInCR(libya,africa)]
locatedInCR(kazakhstan,americas).	False	None	None
locatedInCR(sudan,africa).	True	2	[neighborOf(sudan,libya),locatedInCR(libya,africa)]
locatedInCR(sudan,oceania).	True	None	None
locatedInCR(sudan,asia).	True	3	[neighborOf(sudan,egypt),neighborOf(egypt,israel),locatedInCR(israel,asia)]
locatedInCR(sudan,europe).	True	5	[neighborOf(sudan,libya),neighborOf(libya,algeria),neighborOf(algeria,morocco),neighborOf(morocco,spain),locatedInCR(spain,europe)]
locatedInCR(sudan,americas).	False	None	None
locatedInCR(united_arab_emirates,asia).	True	3	[neighborOf(united_arab_emirates,oman),neighborOf(oman,yemen),locatedInCR(yemen,asia)]
locatedInCR(united_arab_emirates,oceania).	True	11	[neighborOf(united_arab_emirates,saudi_arabia),neighborOf(saudi_arabia,iraq),neighborOf(iraq,iran),neighborOf(iran,afghanistan),neighborOf(afghanistan,china),neighborOf(china,myanmar),neighborOf(myanmar,thailand),neighborOf(thailand,malaysia),neighborOf(malaysia,indonesia),neighborOf(indonesia,papua_new_guinea),locatedInCR(papua_new_guinea,oceania)]
locatedInCR(united_arab_emirates,europe).	True	6	[neighborOf(united_arab_emirates,saudi_arabia),neighborOf(saudi_arabia,iraq),neighborOf(iraq,turkey),neighborOf(turkey,azerbaijan),neighborOf(azerbaijan,russia),locatedInCR(russia,europe)]
locatedInCR(united_arab_emirates,africa).	True	6	[neighborOf(united_arab_emirates,saudi_arabia),neighborOf(saudi_arabia,jordan),neighborOf(jordan,israel),neighborOf(israel,egypt),neighborOf(egypt,libya),locatedInCR(libya,africa)]
locatedInCR(united_arab_emirates,americas).	False	None	None
locatedInCR(croatia,europe).	True	2	[neighborOf(croatia,slovenia),locatedInCR(slovenia,europe)]
locatedInCR(croatia,oceania).	True	10	[neighborOf(croatia,hungary),neighborOf(hungary,ukraine),neighborOf(ukraine,russia),neighborOf(russia,china),neighborOf(china,myanmar),neighborOf(myanmar,thailand),neighborOf(thailand,malaysia),neighborOf(malaysia,indonesia),neighborOf(indonesia,papua_new_guinea),locatedInCR(papua_new_guinea,oceania)]
locatedInCR(croatia,asia).	True	5	[neighborOf(croatia,serbia),neighborOf(serbia,bulgaria),neighborOf(bulgaria,turkey),neighborOf(turkey,azerbaijan),locatedInCR(azerbaijan,asia)]
locatedInCR(croatia,africa).	True	7	[neighborOf(croatia,slovenia),neighborOf(slovenia,italy),neighborOf(italy,france),neighborOf(france,spain),neighborOf(spain,morocco),neighborOf(morocco,western_sahara),locatedInCR(western_sahara,africa)]
locatedInCR(croatia,americas).	False	None	None
locatedInCR(kuwait,asia).	True	2	[neighborOf(kuwait,iraq),locatedInCR(iraq,asia)]
locatedInCR(kuwait,oceania).	True	10	[neighborOf(kuwait,iraq),neighborOf(iraq,iran),neighborOf(iran,afghanistan),neighborOf(afghanistan,china),neighborOf(china,myanmar),neighborOf(myanmar,thailand),neighborOf(thailand,malaysia),neighborOf(malaysia,indonesia),neighborOf(indonesia,papua_new_guinea),locatedInCR(papua_new_guinea,oceania)]
locatedInCR(kuwait,europe).	True	5	[neighborOf(kuwait,iraq),neighborOf(iraq,turkey),neighborOf(turkey,azerbaijan),neighborOf(azerbaijan,russia),locatedInCR(russia,europe)]
locatedInCR(kuwait,africa).	True	6	[neighborOf(kuwait,saudi_arabia),neighborOf(saudi_arabia,jordan),neighborOf(jordan,israel),neighborOf(israel,egypt),neighborOf(egypt,libya),locatedInCR(libya,africa)]
locatedInCR(kuwait,americas).	False	None	None
locatedInCR(angola,africa).	True	2	[neighborOf(angola,zambia),locatedInCR(zambia,africa)]
locatedInCR(angola,oceania).	True	None	None
locatedInCR(angola,asia).	True	6	[neighborOf(angola,dr_congo),neighborOf(dr_congo,south_sudan),neighborOf(south_sudan,sudan),neighborOf(sudan,egypt),neighborOf(egypt,israel),locatedInCR(israel,asia)]
locatedInCR(angola,europe).	True	8	[neighborOf(angola,dr_congo),neighborOf(dr_congo,south_sudan),neighborOf(south_sudan,sudan),neighborOf(sudan,libya),neighborOf(libya,algeria),neighborOf(algeria,morocco),neighborOf(morocco,spain),locatedInCR(spain,europe)]
locatedInCR(angola,americas).	False	None	None
locatedInCR(niger,africa).	True	2	[neighborOf(niger,libya),locatedInCR(libya,africa)]
locatedInCR(niger,oceania).	True	None	None
locatedInCR(niger,asia).	True	4	[neighborOf(niger,libya),neighborOf(libya,egypt),neighborOf(egypt,israel),locatedInCR(israel,asia)]
locatedInCR(niger,europe).	True	4	[neighborOf(niger,algeria),neighborOf(algeria,morocco),neighborOf(morocco,spain),locatedInCR(spain,europe)]
locatedInCR(niger,americas).	False	None	None
locatedInCR(somalia,africa).	True	3	[neighborOf(somalia,kenya),neighborOf(kenya,south_sudan),locatedInCR(south_sudan,africa)]
locatedInCR(somalia,oceania).	True	None	None
locatedInCR(somalia,asia).	True	5	[neighborOf(somalia,ethiopia),neighborOf(ethiopia,sudan),neighborOf(sudan,egypt),neighborOf(egypt,israel),locatedInCR(israel,asia)]
locatedInCR(somalia,europe).	True	7	[neighborOf(somalia,ethiopia),neighborOf(ethiopia,sudan),neighborOf(sudan,libya),neighborOf(libya,algeria),neighborOf(algeria,morocco),neighborOf(morocco,spain),locatedInCR(spain,europe)]
locatedInCR(somalia,americas).	False	None	None
locatedInCR(luxembourg,europe).	True	2	[neighborOf(luxembourg,belgium),locatedInCR(belgium,europe)]
locatedInCR(luxembourg,oceania).	True	10	[neighborOf(luxembourg,germany),neighborOf(germany,poland),neighborOf(poland,russia),neighborOf(russia,china),neighborOf(china,myanmar),neighborOf(myanmar,thailand),neighborOf(thailand,malaysia),neighborOf(malaysia,indonesia),neighborOf(indonesia,papua_new_guinea),locatedInCR(papua_new_guinea,oceania)]
locatedInCR(luxembourg,asia).	True	5	[neighborOf(luxembourg,germany),neighborOf(germany,poland),neighborOf(poland,russia),neighborOf(russia,georgia),locatedInCR(georgia,asia)]
locatedInCR(luxembourg,africa).	True	5	[neighborOf(luxembourg,france),neighborOf(france,spain),neighborOf(spain,morocco),neighborOf(morocco,western_sahara),locatedInCR(western_sahara,africa)]
locatedInCR(luxembourg,americas).	False	None	None
locatedInCR(slovenia,europe).	True	2	[neighborOf(slovenia,croatia),locatedInCR(croatia,europe)]
locatedInCR(slovenia,oceania).	True	10	[neighborOf(slovenia,hungary),neighborOf(hungary,ukraine),neighborOf(ukraine,russia),neighborOf(russia,china),neighborOf(china,myanmar),neighborOf(myanmar,thailand),neighborOf(thailand,malaysia),neighborOf(malaysia,indonesia),neighborOf(indonesia,papua_new_guinea),locatedInCR(papua_new_guinea,oceania)]
locatedInCR(slovenia,asia).	True	5	[neighborOf(slovenia,hungary),neighborOf(hungary,ukraine),neighborOf(ukraine,russia),neighborOf(russia,georgia),locatedInCR(georgia,asia)]
locatedInCR(slovenia,africa).	True	6	[neighborOf(slovenia,italy),neighborOf(italy,france),neighborOf(france,spain),neighborOf(spain,morocco),neighborOf(morocco,western_sahara),locatedInCR(western_sahara,africa)]
locatedInCR(slovenia,americas).	False	None	None
locatedInCR(iran,asia).	True	2	[neighborOf(iran,azerbaijan),locatedInCR(azerbaijan,asia)]
locatedInCR(iran,oceania).	True	8	[neighborOf(iran,afghanistan),neighborOf(afghanistan,china),neighborOf(china,myanmar),neighborOf(myanmar,thailand),neighborOf(thailand,malaysia),neighborOf(malaysia,indonesia),neighborOf(indonesia,papua_new_guinea),locatedInCR(papua_new_guinea,oceania)]
locatedInCR(iran,europe).	True	3	[neighborOf(iran,azerbaijan),neighborOf(azerbaijan,russia),locatedInCR(russia,europe)]
locatedInCR(iran,africa).	True	6	[neighborOf(iran,iraq),neighborOf(iraq,jordan),neighborOf(jordan,israel),neighborOf(israel,egypt),neighborOf(egypt,libya),locatedInCR(libya,africa)]
locatedInCR(iran,americas).	False	None	None
locatedInCR(bhutan,asia).	True	2	[neighborOf(bhutan,china),locatedInCR(china,asia)]
locatedInCR(bhutan,oceania).	True	7	[neighborOf(bhutan,china),neighborOf(china,myanmar),neighborOf(myanmar,thailand),neighborOf(thailand,malaysia),neighborOf(malaysia,indonesia),neighborOf(indonesia,papua_new_guinea),locatedInCR(papua_new_guinea,oceania)]
locatedInCR(bhutan,europe).	True	3	[neighborOf(bhutan,china),neighborOf(china,russia),locatedInCR(russia,europe)]
locatedInCR(bhutan,africa).	True	9	[neighborOf(bhutan,china),neighborOf(china,afghanistan),neighborOf(afghanistan,iran),neighborOf(iran,iraq),neighborOf(iraq,jordan),neighborOf(jordan,israel),neighborOf(israel,egypt),neighborOf(egypt,libya),locatedInCR(libya,africa)]
locatedInCR(bhutan,americas).	False	None	None
locatedInCR(bosnia_and_herzegovina,europe).	True	2	[neighborOf(bosnia_and_herzegovina,croatia),locatedInCR(croatia,europe)]
locatedInCR(bosnia_and_herzegovina,oceania).	True	11	[neighborOf(bosnia_and_herzegovina,serbia),neighborOf(serbia,hungary),neighborOf(hungary,ukraine),neighborOf(ukraine,russia),neighborOf(russia,china),neighborOf(china,myanmar),neighborOf(myanmar,thailand),neighborOf(thailand,malaysia),neighborOf(malaysia,indonesia),neighborOf(indonesia,papua_new_guinea),locatedInCR(papua_new_guinea,oceania)]
locatedInCR(bosnia_and_herzegovina,asia).	True	5	[neighborOf(bosnia_and_herzegovina,serbia),neighborOf(serbia,bulgaria),neighborOf(bulgaria,turkey),neighborOf(turkey,azerbaijan),locatedInCR(azerbaijan,asia)]
locatedInCR(bosnia_and_herzegovina,africa).	True	8	[neighborOf(bosnia_and_herzegovina,serbia),neighborOf(serbia,bulgaria),neighborOf(bulgaria,turkey),neighborOf(turkey,syria),neighborOf(syria,israel),neighborOf(israel,egypt),neighborOf(egypt,libya),locatedInCR(libya,africa)]
locatedInCR(bosnia_and_herzegovina,americas).	False	None	None
locatedInCR(uruguay,americas).	True	2	[neighborOf(uruguay,argentina),locatedInCR(argentina,americas)]
locatedInCR(uruguay,oceania).	False	None	None
locatedInCR(uruguay,asia).	False	None	None
locatedInCR(uruguay,europe).	False	None	None
locatedInCR(uruguay,africa).	False	None	None
locatedInCR(italy,europe).	True	2	[neighborOf(italy,austria),locatedInCR(austria,europe)]
locatedInCR(italy,oceania).	True	11	[neighborOf(italy,austria),neighborOf(austria,germany),neighborOf(germany,poland),neighborOf(poland,russia),neighborOf(russia,china),neighborOf(china,myanmar),neighborOf(myanmar,thailand),neighborOf(thailand,malaysia),neighborOf(malaysia,indonesia),neighborOf(indonesia,papua_new_guinea),locatedInCR(papua_new_guinea,oceania)]
locatedInCR(italy,asia).	True	6	[neighborOf(italy,austria),neighborOf(austria,germany),neighborOf(germany,poland),neighborOf(poland,russia),neighborOf(russia,georgia),locatedInCR(georgia,asia)]
locatedInCR(italy,africa).	True	5	[neighborOf(italy,france),neighborOf(france,spain),neighborOf(spain,morocco),neighborOf(morocco,western_sahara),locatedInCR(western_sahara,africa)]
locatedInCR(italy,americas).	False	None	None
locatedInCR(haiti,americas).	True	2	[neighborOf(haiti,dominican_republic),locatedInCR(dominican_republic,americas)]
locatedInCR(haiti,oceania).	False	None	None
locatedInCR(haiti,asia).	False	None	None
locatedInCR(haiti,europe).	False	None	None
locatedInCR(haiti,africa).	False	None	None
locatedInCR(tajikistan,asia).	True	2	[neighborOf(tajikistan,china),locatedInCR(china,asia)]
locatedInCR(tajikistan,oceania).	True	7	[neighborOf(tajikistan,china),neighborOf(china,myanmar),neighborOf(myanmar,thailand),neighborOf(thailand,malaysia),neighborOf(malaysia,indonesia),neighborOf(indonesia,papua_new_guinea),locatedInCR(papua_new_guinea,oceania)]
locatedInCR(tajikistan,europe).	True	3	[neighborOf(tajikistan,china),neighborOf(china,russia),locatedInCR(russia,europe)]
locatedInCR(tajikistan,africa).	True	8	[neighborOf(tajikistan,afghanistan),neighborOf(afghanistan,iran),neighborOf(iran,iraq),neighborOf(iraq,jordan),neighborOf(jordan,israel),neighborOf(israel,egypt),neighborOf(egypt,libya),locatedInCR(libya,africa)]
locatedInCR(tajikistan,americas).	False	None	None
locatedInCR(spain,europe).	True	2	[neighborOf(spain,portugal),locatedInCR(portugal,europe)]
locatedInCR(spain,oceania).	True	11	[neighborOf(spain,france),neighborOf(france,germany),neighborOf(germany,poland),neighborOf(poland,russia),neighborOf(russia,china),neighborOf(china,myanmar),neighborOf(myanmar,thailand),neighborOf(thailand,malaysia),neighborOf(malaysia,indonesia),neighborOf(indonesia,papua_new_guinea),locatedInCR(papua_new_guinea,oceania)]
locatedInCR(spain,asia).	True	6	[neighborOf(spain,morocco),neighborOf(morocco,algeria),neighborOf(algeria,libya),neighborOf(libya,egypt),neighborOf(egypt,israel),locatedInCR(israel,asia)]
locatedInCR(spain,africa).	True	3	[neighborOf(spain,morocco),neighborOf(morocco,western_sahara),locatedInCR(western_sahara,africa)]
locatedInCR(spain,americas).	False	None	None
locatedInCR(bolivia,americas).	True	2	[neighborOf(bolivia,argentina),locatedInCR(argentina,americas)]
locatedInCR(bolivia,oceania).	False	None	None
locatedInCR(bolivia,asia).	False	None	None
locatedInCR(bolivia,europe).	False	None	None
locatedInCR(bolivia,africa).	False	None	None
locatedInCR(moldova,europe).	True	2	[neighborOf(moldova,ukraine),locatedInCR(ukraine,europe)]
locatedInCR(moldova,oceania).	True	9	[neighborOf(moldova,ukraine),neighborOf(ukraine,russia),neighborOf(russia,china),neighborOf(china,myanmar),neighborOf(myanmar,thailand),neighborOf(thailand,malaysia),neighborOf(malaysia,indonesia),neighborOf(indonesia,papua_new_guinea),locatedInCR(papua_new_guinea,oceania)]
locatedInCR(moldova,asia).	True	4	[neighborOf(moldova,ukraine),neighborOf(ukraine,russia),neighborOf(russia,georgia),locatedInCR(georgia,asia)]
locatedInCR(moldova,africa).	True	8	[neighborOf(moldova,ukraine),neighborOf(ukraine,poland),neighborOf(poland,germany),neighborOf(germany,france),neighborOf(france,spain),neighborOf(spain,morocco),neighborOf(morocco,western_sahara),locatedInCR(western_sahara,africa)]
locatedInCR(moldova,americas).	False	None	None
locatedInCR(french_guiana,americas).	True	2	[neighborOf(french_guiana,suriname),locatedInCR(suriname,americas)]
locatedInCR(french_guiana,oceania).	False	None	None
locatedInCR(french_guiana,asia).	False	None	None
locatedInCR(french_guiana,europe).	False	None	None
locatedInCR(french_guiana,africa).	False	None	None
locatedInCR(myanmar,asia).	True	2	[neighborOf(myanmar,china),locatedInCR(china,asia)]
locatedInCR(myanmar,oceania).	True	5	[neighborOf(myanmar,thailand),neighborOf(thailand,malaysia),neighborOf(malaysia,indonesia),neighborOf(indonesia,papua_new_guinea),locatedInCR(papua_new_guinea,oceania)]
locatedInCR(myanmar,europe).	True	3	[neighborOf(myanmar,china),neighborOf(china,russia),locatedInCR(russia,europe)]
locatedInCR(myanmar,africa).	True	9	[neighborOf(myanmar,china),neighborOf(china,afghanistan),neighborOf(afghanistan,iran),neighborOf(iran,iraq),neighborOf(iraq,jordan),neighborOf(jordan,israel),neighborOf(israel,egypt),neighborOf(egypt,libya),locatedInCR(libya,africa)]
locatedInCR(myanmar,americas).	False	None	None
locatedInCR(western_sahara,africa).	True	2	[neighborOf(western_sahara,mauritania),locatedInCR(mauritania,africa)]
locatedInCR(western_sahara,oceania).	True	None	None
locatedInCR(western_sahara,asia).	True	5	[neighborOf(western_sahara,algeria),neighborOf(algeria,libya),neighborOf(libya,egypt),neighborOf(egypt,israel),locatedInCR(israel,asia)]
locatedInCR(western_sahara,europe).	True	3	[neighborOf(western_sahara,morocco),neighborOf(morocco,spain),locatedInCR(spain,europe)]
locatedInCR(western_sahara,americas).	False	None	None
locatedInCR(finland,europe).	True	2	[neighborOf(finland,russia),locatedInCR(russia,europe)]
locatedInCR(finland,oceania).	True	8	[neighborOf(finland,russia),neighborOf(russia,china),neighborOf(china,myanmar),neighborOf(myanmar,thailand),neighborOf(thailand,malaysia),neighborOf(malaysia,indonesia),neighborOf(indonesia,papua_new_guinea),locatedInCR(papua_new_guinea,oceania)]
locatedInCR(finland,asia).	True	3	[neighborOf(finland,russia),neighborOf(russia,georgia),locatedInCR(georgia,asia)]
locatedInCR(finland,africa).	True	8	[neighborOf(finland,russia),neighborOf(russia,georgia),neighborOf(georgia,turkey),neighborOf(turkey,syria),neighborOf(syria,israel),neighborOf(israel,egypt),neighborOf(egypt,libya),locatedInCR(libya,africa)]
locatedInCR(finland,americas).	False	None	None
locatedInCR(nigeria,africa).	True	2	[neighborOf(nigeria,chad),locatedInCR(chad,africa)]
locatedInCR(nigeria,oceania).	True	None	None
locatedInCR(nigeria,asia).	True	5	[neighborOf(nigeria,chad),neighborOf(chad,libya),neighborOf(libya,egypt),neighborOf(egypt,israel),locatedInCR(israel,asia)]
locatedInCR(nigeria,europe).	True	5	[neighborOf(nigeria,niger),neighborOf(niger,algeria),neighborOf(algeria,morocco),neighborOf(morocco,spain),locatedInCR(spain,europe)]
locatedInCR(nigeria,americas).	False	None	None
locatedInCR(malawi,africa).	True	2	[neighborOf(malawi,zambia),locatedInCR(zambia,africa)]
locatedInCR(malawi,oceania).	True	None	None
locatedInCR(malawi,asia).	True	7	[neighborOf(malawi,tanzania),neighborOf(tanzania,kenya),neighborOf(kenya,south_sudan),neighborOf(south_sudan,sudan),neighborOf(sudan,egypt),neighborOf(egypt,israel),locatedInCR(israel,asia)]
locatedInCR(malawi,europe).	True	9	[neighborOf(malawi,tanzania),neighborOf(tanzania,kenya),neighborOf(kenya,south_sudan),neighborOf(south_sudan,sudan),neighborOf(sudan,libya),neighborOf(libya,algeria),neighborOf(algeria,morocco),neighborOf(morocco,spain),locatedInCR(spain,europe)]
locatedInCR(malawi,americas).	False	None	None
locatedInCR(suriname,americas).	True	2	[neighborOf(suriname,french_guiana),locatedInCR(french_guiana,americas)]
locatedInCR(suriname,oceania).	False	None	None
locatedInCR(suriname,asia).	False	None	None
locatedInCR(suriname,europe).	False	None	None
locatedInCR(suriname,africa).	False	None	None
locatedInCR(ivory_coast,africa).	True	2	[neighborOf(ivory_coast,guinea),locatedInCR(guinea,africa)]
locatedInCR(ivory_coast,oceania).	True	None	None
locatedInCR(ivory_coast,asia).	True	6	[neighborOf(ivory_coast,mali),neighborOf(mali,niger),neighborOf(niger,libya),neighborOf(libya,egypt),neighborOf(egypt,israel),locatedInCR(israel,asia)]
locatedInCR(ivory_coast,europe).	True	5	[neighborOf(ivory_coast,mali),neighborOf(mali,algeria),neighborOf(algeria,morocco),neighborOf(morocco,spain),locatedInCR(spain,europe)]
locatedInCR(ivory_coast,americas).	False	None	None
locatedInCR(libya,africa).	True	2	[neighborOf(libya,niger),locatedInCR(niger,africa)]
locatedInCR(libya,oceania).	True	None	None
locatedInCR(libya,asia).	True	3	[neighborOf(libya,egypt),neighborOf(egypt,israel),locatedInCR(israel,asia)]
locatedInCR(libya,europe).	True	4	[neighborOf(libya,algeria),neighborOf(algeria,morocco),neighborOf(morocco,spain),locatedInCR(spain,europe)]
locatedInCR(libya,americas).	False	None	None
locatedInCR(azerbaijan,asia).	True	2	[neighborOf(azerbaijan,georgia),locatedInCR(georgia,asia)]
locatedInCR(azerbaijan,oceania).	True	8	[neighborOf(azerbaijan,russia),neighborOf(russia,china),neighborOf(china,myanmar),neighborOf(myanmar,thailand),neighborOf(thailand,malaysia),neighborOf(malaysia,indonesia),neighborOf(indonesia,papua_new_guinea),locatedInCR(papua_new_guinea,oceania)]
locatedInCR(azerbaijan,europe).	True	2	[neighborOf(azerbaijan,russia),locatedInCR(russia,europe)]
locatedInCR(azerbaijan,africa).	True	6	[neighborOf(azerbaijan,turkey),neighborOf(turkey,syria),neighborOf(syria,israel),neighborOf(israel,egypt),neighborOf(egypt,libya),locatedInCR(libya,africa)]
locatedInCR(azerbaijan,americas).	False	None	None
locatedInCR(macau,asia).	True	2	[neighborOf(macau,china),locatedInCR(china,asia)]
locatedInCR(macau,oceania).	True	7	[neighborOf(macau,china),neighborOf(china,myanmar),neighborOf(myanmar,thailand),neighborOf(thailand,malaysia),neighborOf(malaysia,indonesia),neighborOf(indonesia,papua_new_guinea),locatedInCR(papua_new_guinea,oceania)]
locatedInCR(macau,europe).	True	3	[neighborOf(macau,china),neighborOf(china,russia),locatedInCR(russia,europe)]
locatedInCR(macau,africa).	True	9	[neighborOf(macau,china),neighborOf(china,afghanistan),neighborOf(afghanistan,iran),neighborOf(iran,iraq),neighborOf(iraq,jordan),neighborOf(jordan,israel),neighborOf(israel,egypt),neighborOf(egypt,libya),locatedInCR(libya,africa)]
locatedInCR(macau,americas).	False	None	None
locatedInCR(uzbekistan,asia).	True	2	[neighborOf(uzbekistan,kazakhstan),locatedInCR(kazakhstan,asia)]
locatedInCR(uzbekistan,oceania).	True	8	[neighborOf(uzbekistan,kazakhstan),neighborOf(kazakhstan,china),neighborOf(china,myanmar),neighborOf(myanmar,thailand),neighborOf(thailand,malaysia),neighborOf(malaysia,indonesia),neighborOf(indonesia,papua_new_guinea),locatedInCR(papua_new_guinea,oceania)]
locatedInCR(uzbekistan,europe).	True	3	[neighborOf(uzbekistan,kazakhstan),neighborOf(kazakhstan,russia),locatedInCR(russia,europe)]
locatedInCR(uzbekistan,africa).	True	8	[neighborOf(uzbekistan,afghanistan),neighborOf(afghanistan,iran),neighborOf(iran,iraq),neighborOf(iraq,jordan),neighborOf(jordan,israel),neighborOf(israel,egypt),neighborOf(egypt,libya),locatedInCR(libya,africa)]
locatedInCR(uzbekistan,americas).	False	None	None
locatedInCR(cameroon,africa).	True	2	[neighborOf(cameroon,gabon),locatedInCR(gabon,africa)]
locatedInCR(cameroon,oceania).	True	None	None
locatedInCR(cameroon,asia).	True	5	[neighborOf(cameroon,central_african_republic),neighborOf(central_african_republic,sudan),neighborOf(sudan,egypt),neighborOf(egypt,israel),locatedInCR(israel,asia)]
locatedInCR(cameroon,europe).	True	6	[neighborOf(cameroon,nigeria),neighborOf(nigeria,niger),neighborOf(niger,algeria),neighborOf(algeria,morocco),neighborOf(morocco,spain),locatedInCR(spain,europe)]
locatedInCR(cameroon,americas).	False	None	None
locatedInCR(czechia,europe).	True	2	[neighborOf(czechia,austria),locatedInCR(austria,europe)]
locatedInCR(czechia,oceania).	True	9	[neighborOf(czechia,poland),neighborOf(poland,russia),neighborOf(russia,china),neighborOf(china,myanmar),neighborOf(myanmar,thailand),neighborOf(thailand,malaysia),neighborOf(malaysia,indonesia),neighborOf(indonesia,papua_new_guinea),locatedInCR(papua_new_guinea,oceania)]
locatedInCR(czechia,asia).	True	4	[neighborOf(czechia,poland),neighborOf(poland,russia),neighborOf(russia,georgia),locatedInCR(georgia,asia)]
locatedInCR(czechia,africa).	True	6	[neighborOf(czechia,germany),neighborOf(germany,france),neighborOf(france,spain),neighborOf(spain,morocco),neighborOf(morocco,western_sahara),locatedInCR(western_sahara,africa)]
locatedInCR(czechia,americas).	False	None	None
locatedInCR(iraq,asia).	True	2	[neighborOf(iraq,iran),locatedInCR(iran,asia)]
locatedInCR(iraq,oceania).	True	9	[neighborOf(iraq,iran),neighborOf(iran,afghanistan),neighborOf(afghanistan,china),neighborOf(china,myanmar),neighborOf(myanmar,thailand),neighborOf(thailand,malaysia),neighborOf(malaysia,indonesia),neighborOf(indonesia,papua_new_guinea),locatedInCR(papua_new_guinea,oceania)]
locatedInCR(iraq,europe).	True	4	[neighborOf(iraq,turkey),neighborOf(turkey,azerbaijan),neighborOf(azerbaijan,russia),locatedInCR(russia,europe)]
locatedInCR(iraq,africa).	True	5	[neighborOf(iraq,jordan),neighborOf(jordan,israel),neighborOf(israel,egypt),neighborOf(egypt,libya),locatedInCR(libya,africa)]
locatedInCR(iraq,americas).	False	None	None
locatedInCR(dominican_republic,americas).	True	2	[neighborOf(dominican_republic,haiti),locatedInCR(haiti,americas)]
locatedInCR(dominican_republic,oceania).	False	None	None
locatedInCR(dominican_republic,asia).	False	None	None
locatedInCR(dominican_republic,europe).	False	None	None
locatedInCR(dominican_republic,africa).	False	None	None
locatedInCR(gambia,africa).	True	3	[neighborOf(gambia,senegal),neighborOf(senegal,mauritania),locatedInCR(mauritania,africa)]
locatedInCR(gambia,oceania).	True	None	None
locatedInCR(gambia,asia).	True	7	[neighborOf(gambia,senegal),neighborOf(senegal,mali),neighborOf(mali,niger),neighborOf(niger,libya),neighborOf(libya,egypt),neighborOf(egypt,israel),locatedInCR(israel,asia)]
locatedInCR(gambia,europe).	True	6	[neighborOf(gambia,senegal),neighborOf(senegal,mali),neighborOf(mali,algeria),neighborOf(algeria,morocco),neighborOf(morocco,spain),locatedInCR(spain,europe)]
locatedInCR(gambia,americas).	False	None	None
locatedInCR(panama,americas).	True	2	[neighborOf(panama,costa_rica),locatedInCR(costa_rica,americas)]
locatedInCR(panama,oceania).	False	None	None
locatedInCR(panama,asia).	False	None	None
locatedInCR(panama,europe).	False	None	None
locatedInCR(panama,africa).	False	None	None
locatedInCR(belgium,europe).	True	2	[neighborOf(belgium,luxembourg),locatedInCR(luxembourg,europe)]
locatedInCR(belgium,oceania).	True	10	[neighborOf(belgium,germany),neighborOf(germany,poland),neighborOf(poland,russia),neighborOf(russia,china),neighborOf(china,myanmar),neighborOf(myanmar,thailand),neighborOf(thailand,malaysia),neighborOf(malaysia,indonesia),neighborOf(indonesia,papua_new_guinea),locatedInCR(papua_new_guinea,oceania)]
locatedInCR(belgium,asia).	True	5	[neighborOf(belgium,germany),neighborOf(germany,poland),neighborOf(poland,russia),neighborOf(russia,georgia),locatedInCR(georgia,asia)]
locatedInCR(belgium,africa).	True	5	[neighborOf(belgium,france),neighborOf(france,spain),neighborOf(spain,morocco),neighborOf(morocco,western_sahara),locatedInCR(western_sahara,africa)]
locatedInCR(belgium,americas).	False	None	None
locatedInCR(russia,europe).	True	2	[neighborOf(russia,lithuania),locatedInCR(lithuania,europe)]
locatedInCR(russia,oceania).	True	7	[neighborOf(russia,china),neighborOf(china,myanmar),neighborOf(myanmar,thailand),neighborOf(thailand,malaysia),neighborOf(malaysia,indonesia),neighborOf(indonesia,papua_new_guinea),locatedInCR(papua_new_guinea,oceania)]
locatedInCR(russia,asia).	True	2	[neighborOf(russia,georgia),locatedInCR(georgia,asia)]
locatedInCR(russia,africa).	True	7	[neighborOf(russia,georgia),neighborOf(georgia,turkey),neighborOf(turkey,syria),neighborOf(syria,israel),neighborOf(israel,egypt),neighborOf(egypt,libya),locatedInCR(libya,africa)]
locatedInCR(russia,americas).	False	None	None
locatedInCR(mauritania,africa).	True	2	[neighborOf(mauritania,western_sahara),locatedInCR(western_sahara,africa)]
locatedInCR(mauritania,oceania).	True	None	None
locatedInCR(mauritania,asia).	True	5	[neighborOf(mauritania,algeria),neighborOf(algeria,libya),neighborOf(libya,egypt),neighborOf(egypt,israel),locatedInCR(israel,asia)]
locatedInCR(mauritania,europe).	True	4	[neighborOf(mauritania,western_sahara),neighborOf(western_sahara,morocco),neighborOf(morocco,spain),locatedInCR(spain,europe)]
locatedInCR(mauritania,americas).	False	None	None
locatedInCR(guinea_bissau,africa).	True	2	[neighborOf(guinea_bissau,guinea),locatedInCR(guinea,africa)]
locatedInCR(guinea_bissau,oceania).	True	None	None
locatedInCR(guinea_bissau,asia).	True	7	[neighborOf(guinea_bissau,senegal),neighborOf(senegal,mali),neighborOf(mali,niger),neighborOf(niger,libya),neighborOf(libya,egypt),neighborOf(egypt,israel),locatedInCR(israel,asia)]
locatedInCR(guinea_bissau,europe).	True	6	[neighborOf(guinea_bissau,senegal),neighborOf(senegal,mali),neighborOf(mali,algeria),neighborOf(algeria,morocco),neighborOf(morocco,spain),locatedInCR(spain,europe)]
locatedInCR(guinea_bissau,americas).	False	None	None
locatedInCR(burundi,africa).	True	3	[neighborOf(burundi,rwanda),neighborOf(rwanda,uganda),locatedInCR(uganda,africa)]
locatedInCR(burundi,oceania).	True	None	None
locatedInCR(burundi,asia).	True	6	[neighborOf(burundi,dr_congo),neighborOf(dr_congo,south_sudan),neighborOf(south_sudan,sudan),neighborOf(sudan,egypt),neighborOf(egypt,israel),locatedInCR(israel,asia)]
locatedInCR(burundi,europe).	True	8	[neighborOf(burundi,dr_congo),neighborOf(dr_congo,south_sudan),neighborOf(south_sudan,sudan),neighborOf(sudan,libya),neighborOf(libya,algeria),neighborOf(algeria,morocco),neighborOf(morocco,spain),locatedInCR(spain,europe)]
locatedInCR(burundi,americas).	False	None	None
locatedInCR(cambodia,asia).	True	2	[neighborOf(cambodia,thailand),locatedInCR(thailand,asia)]
locatedInCR(cambodia,oceania).	True	5	[neighborOf(cambodia,thailand),neighborOf(thailand,malaysia),neighborOf(malaysia,indonesia),neighborOf(indonesia,papua_new_guinea),locatedInCR(papua_new_guinea,oceania)]
locatedInCR(cambodia,europe).	True	4	[neighborOf(cambodia,vietnam),neighborOf(vietnam,china),neighborOf(china,russia),locatedInCR(russia,europe)]
locatedInCR(cambodia,africa).	True	10	[neighborOf(cambodia,vietnam),neighborOf(vietnam,china),neighborOf(china,afghanistan),neighborOf(afghanistan,iran),neighborOf(iran,iraq),neighborOf(iraq,jordan),neighborOf(jordan,israel),neighborOf(israel,egypt),neighborOf(egypt,libya),locatedInCR(libya,africa)]
locatedInCR(cambodia,americas).	False	None	None
locatedInCR(chad,africa).	True	2	[neighborOf(chad,cameroon),locatedInCR(cameroon,africa)]
locatedInCR(chad,oceania).	True	None	None
locatedInCR(chad,asia).	True	4	[neighborOf(chad,libya),neighborOf(libya,egypt),neighborOf(egypt,israel),locatedInCR(israel,asia)]
locatedInCR(chad,europe).	True	5	[neighborOf(chad,niger),neighborOf(niger,algeria),neighborOf(algeria,morocco),neighborOf(morocco,spain),locatedInCR(spain,europe)]
locatedInCR(chad,americas).	False	None	None
locatedInCR(afghanistan,asia).	True	2	[neighborOf(afghanistan,iran),locatedInCR(iran,asia)]
locatedInCR(afghanistan,oceania).	True	7	[neighborOf(afghanistan,china),neighborOf(china,myanmar),neighborOf(myanmar,thailand),neighborOf(thailand,malaysia),neighborOf(malaysia,indonesia),neighborOf(indonesia,papua_new_guinea),locatedInCR(papua_new_guinea,oceania)]
locatedInCR(afghanistan,europe).	True	3	[neighborOf(afghanistan,china),neighborOf(china,russia),locatedInCR(russia,europe)]
locatedInCR(afghanistan,africa).	True	7	[neighborOf(afghanistan,iran),neighborOf(iran,iraq),neighborOf(iraq,jordan),neighborOf(jordan,israel),neighborOf(israel,egypt),neighborOf(egypt,libya),locatedInCR(libya,africa)]
locatedInCR(afghanistan,americas).	False	None	None
locatedInCR(uganda,africa).	True	2	[neighborOf(uganda,south_sudan),locatedInCR(south_sudan,africa)]
locatedInCR(uganda,oceania).	True	None	None
locatedInCR(uganda,asia).	True	5	[neighborOf(uganda,south_sudan),neighborOf(south_sudan,sudan),neighborOf(sudan,egypt),neighborOf(egypt,israel),locatedInCR(israel,asia)]
locatedInCR(uganda,europe).	True	7	[neighborOf(uganda,south_sudan),neighborOf(south_sudan,sudan),neighborOf(sudan,libya),neighborOf(libya,algeria),neighborOf(algeria,morocco),neighborOf(morocco,spain),locatedInCR(spain,europe)]
locatedInCR(uganda,americas).	False	None	None
locatedInCR(gabon,africa).	True	2	[neighborOf(gabon,cameroon),locatedInCR(cameroon,africa)]
locatedInCR(gabon,oceania).	True	None	None
locatedInCR(gabon,asia).	True	6	[neighborOf(gabon,cameroon),neighborOf(cameroon,central_african_republic),neighborOf(central_african_republic,sudan),neighborOf(sudan,egypt),neighborOf(egypt,israel),locatedInCR(israel,asia)]
locatedInCR(gabon,europe).	True	7	[neighborOf(gabon,cameroon),neighborOf(cameroon,nigeria),neighborOf(nigeria,niger),neighborOf(niger,algeria),neighborOf(algeria,morocco),neighborOf(morocco,spain),locatedInCR(spain,europe)]
locatedInCR(gabon,americas).	False	None	None
locatedInCR(israel,asia).	True	3	[neighborOf(israel,syria),neighborOf(syria,iraq),locatedInCR(iraq,asia)]
locatedInCR(israel,oceania).	True	11	[neighborOf(israel,syria),neighborOf(syria,iraq),neighborOf(iraq,iran),neighborOf(iran,afghanistan),neighborOf(afghanistan,china),neighborOf(china,myanmar),neighborOf(myanmar,thailand),neighborOf(thailand,malaysia),neighborOf(malaysia,indonesia),neighborOf(indonesia,papua_new_guinea),locatedInCR(papua_new_guinea,oceania)]
locatedInCR(israel,europe).	True	5	[neighborOf(israel,syria),neighborOf(syria,turkey),neighborOf(turkey,azerbaijan),neighborOf(azerbaijan,russia),locatedInCR(russia,europe)]
locatedInCR(israel,africa).	True	3	[neighborOf(israel,egypt),neighborOf(egypt,libya),locatedInCR(libya,africa)]
locatedInCR(israel,americas).	False	None	None
locatedInCR(costa_rica,americas).	True	2	[neighborOf(costa_rica,panama),locatedInCR(panama,americas)]
locatedInCR(costa_rica,oceania).	False	None	None
locatedInCR(costa_rica,asia).	False	None	None
locatedInCR(costa_rica,europe).	False	None	None
locatedInCR(costa_rica,africa).	False	None	None
locatedInCR(austria,europe).	True	2	[neighborOf(austria,italy),locatedInCR(italy,europe)]
locatedInCR(austria,oceania).	True	10	[neighborOf(austria,germany),neighborOf(germany,poland),neighborOf(poland,russia),neighborOf(russia,china),neighborOf(china,myanmar),neighborOf(myanmar,thailand),neighborOf(thailand,malaysia),neighborOf(malaysia,indonesia),neighborOf(indonesia,papua_new_guinea),locatedInCR(papua_new_guinea,oceania)]
locatedInCR(austria,asia).	True	5	[neighborOf(austria,germany),neighborOf(germany,poland),neighborOf(poland,russia),neighborOf(russia,georgia),locatedInCR(georgia,asia)]
locatedInCR(austria,africa).	True	6	[neighborOf(austria,italy),neighborOf(italy,france),neighborOf(france,spain),neighborOf(spain,morocco),neighborOf(morocco,western_sahara),locatedInCR(western_sahara,africa)]
locatedInCR(austria,americas).	False	None	None
locatedInCR(lithuania,europe).	True	2	[neighborOf(lithuania,russia),locatedInCR(russia,europe)]
locatedInCR(lithuania,oceania).	True	8	[neighborOf(lithuania,russia),neighborOf(russia,china),neighborOf(china,myanmar),neighborOf(myanmar,thailand),neighborOf(thailand,malaysia),neighborOf(malaysia,indonesia),neighborOf(indonesia,papua_new_guinea),locatedInCR(papua_new_guinea,oceania)]
locatedInCR(lithuania,asia).	True	3	[neighborOf(lithuania,russia),neighborOf(russia,georgia),locatedInCR(georgia,asia)]
locatedInCR(lithuania,africa).	True	7	[neighborOf(lithuania,poland),neighborOf(poland,germany),neighborOf(germany,france),neighborOf(france,spain),neighborOf(spain,morocco),neighborOf(morocco,western_sahara),locatedInCR(western_sahara,africa)]
locatedInCR(lithuania,americas).	False	None	None
locatedInCR(yemen,asia).	True	3	[neighborOf(yemen,saudi_arabia),neighborOf(saudi_arabia,qatar),locatedInCR(qatar,asia)]
locatedInCR(yemen,oceania).	True	11	[neighborOf(yemen,saudi_arabia),neighborOf(saudi_arabia,iraq),neighborOf(iraq,iran),neighborOf(iran,afghanistan),neighborOf(afghanistan,china),neighborOf(china,myanmar),neighborOf(myanmar,thailand),neighborOf(thailand,malaysia),neighborOf(malaysia,indonesia),neighborOf(indonesia,papua_new_guinea),locatedInCR(papua_new_guinea,oceania)]
locatedInCR(yemen,europe).	True	6	[neighborOf(yemen,saudi_arabia),neighborOf(saudi_arabia,iraq),neighborOf(iraq,turkey),neighborOf(turkey,azerbaijan),neighborOf(azerbaijan,russia),locatedInCR(russia,europe)]
locatedInCR(yemen,africa).	True	6	[neighborOf(yemen,saudi_arabia),neighborOf(saudi_arabia,jordan),neighborOf(jordan,israel),neighborOf(israel,egypt),neighborOf(egypt,libya),locatedInCR(libya,africa)]
locatedInCR(yemen,americas).	False	None	None
